3 3 3 3 3 3 3 3 3 3 3 3 3 3 3 
3 3 3 3 3 3 3 5 3 3 3 3 3 3 3
3 3 3 3 3 3 3 0 3 3 3 3 3 3 3 
3 3 0 0 0 0 0 0 0 0 0 0 3 3 3 
3 3 0 0 0 6 0 0 0 0 4 0 3 3 3 
3 3 0 0 0 6 0 0 0 0 0 0 3 3 3 
3 3 0 0 0 0 0 0 0 0 0 0 3 3 3 
3 3 0 0 6 0 0 0 0 0 6 0 3 3 3 
3 3 0 0 0 6 0 0 0 6 0 0 3 3 3 
3 3 0 0 0 0 6 0 6 0 0 0 3 3 3 
3 3 0 0 0 0 0 6 0 0 0 0 0 5 3 
3 3 0 0 0 0 6 0 6 0 0 0 3 3 3 
3 3 0 0 0 6 0 0 0 6 0 0 3 3 3 
3 3 0 0 6 0 0 0 0 0 6 0 3 3 3 
3 3 0 0 0 0 0 0 0 0 0 0 3 3 3 
3 3 0 0 0 0 0 0 0 0 0 0 3 3 3 
3 3 0 0 0 0 0 0 0 6 0 0 3 3 3 
3 3 0 0 0 0 0 0 0 6 0 0 3 3 3 
3 3 3 3 3 3 3 0 3 3 3 3 3 3 3 
3 3 3 3 3 3 3 5 3 3 3 3 3 3 3 
3 3 3 3 3 3 3 3 3 3 3 3 3 3 3 