3 3 3 3 3 3 3 3 3 3 3 3 3 3 3 
3 3 3 3 3 3 3 3 3 3 3 3 3 3 3
3 3 3 3 3 3 3 3 3 3 3 3 3 3 3 
3 3 0 0 0 0 0 0 0 0 0 0 3 3 3 
3 3 0 0 0 0 0 0 0 0 0 0 3 3 3 
3 3 0 0 0 0 0 0 0 0 0 0 3 3 3 
3 3 0 0 0 0 0 0 0 0 0 0 3 3 3 
3 3 0 0 0 0 0 0 0 0 0 0 3 3 3 
3 3 0 0 0 0 0 0 0 0 0 0 3 3 3 
3 3 0 0 0 0 0 0 0 0 0 0 3 3 3 
3 5 0 0 0 0 0 12 0 0 0 0 3 5 3 
3 3 0 0 0 0 0 0 0 0 0 0 3 3 3 
3 3 0 0 0 0 0 0 0 0 0 0 3 3 3 
3 3 0 0 0 0 0 0 0 0 0 0 3 3 3 
3 3 0 0 0 0 0 0 0 0 0 0 3 3 3 
3 3 0 0 0 0 0 0 0 0 0 0 3 3 3 
3 3 0 0 0 0 0 0 0 0 0 0 3 3 3 
3 3 0 0 0 0 0 0 0 0 0 0 3 3 3 
3 3 3 3 3 3 3 3 3 3 3 3 3 3 3 
3 3 3 3 3 3 3 3 3 3 3 3 3 3 3 
3 3 3 3 3 3 3 3 3 3 3 3 3 3 3 