3 3 3 3 3 3 3 3 3 3 3 3 3 3 3 
3 3 3 3 3 3 3 5 3 3 3 3 3 3 3
3 3 3 3 3 3 3 0 3 3 3 3 3 3 3 
3 3 0 0 0 0 6 0 6 0 0 0 3 3 3 
3 3 0 0 0 0 6 0 6 0 0 0 3 3 3 
3 3 0 0 0 0 6 0 6 0 0 0 3 3 3 
3 3 0 0 0 0 13 13 13 0 0 0 3 3 3 
3 3 0 0 0 0 13 13 13 0 0 0 3 3 3 
3 3 0 0 0 0 13 13 13 0 0 0 3 3 3 
3 3 0 0 0 0 0 0 0 0 0 0 3 3 3 
3 5 0 0 0 0 0 0 0 0 0 0 0 5 3 
3 3 0 0 0 0 0 0 0 0 0 0 3 3 3 
3 3 0 0 0 0 8 8 8 0 0 0 3 3 3 
3 3 0 0 0 0 8 8 8 0 0 0 3 3 3 
3 3 0 0 0 0 8 8 8 0 0 0 3 3 3 
3 3 0 0 0 0 6 0 6 0 0 0 3 3 3 
3 3 0 10 0 0 6 0 6 0 0 0 3 3 3 
3 3 0 0 0 0 6 0 6 0 0 0 3 3 3 
3 3 3 3 3 3 3 0 3 3 3 3 3 3 3 
3 3 3 3 3 3 3 5 3 3 3 3 3 3 3 
3 3 3 3 3 3 3 3 3 3 3 3 3 3 3 