3 3 3 3 3 3 3 3 3 3 3 3 3 3 3 
3 9 9 9 9 9 9 5 9 9 9 9 9 9 3
3 9 9 9 9 9 0 0 0 9 9 9 9 9 3 
3 9 9 9 9 9 0 0 0 9 9 9 9 9 3 
3 9 9 9 9 9 9 0 9 9 9 9 9 9 3 
3 9 9 9 9 9 9 0 9 9 9 9 9 9 3 
3 9 9 9 9 9 9 0 9 9 9 9 9 9 3 
3 9 9 9 9 9 9 0 9 9 9 9 9 9 3 
3 9 9 9 9 9 9 0 9 9 9 9 9 9 3 
3 9 9 9 9 0 0 0 0 9 9 0 0 9 3 
3 9 9 9 9 0 0 0 0 0 0 0 0 5 3 
3 9 9 9 9 0 0 0 0 9 9 0 0 9 3 
3 9 9 9 9 9 0 0 0 9 9 9 9 9 3 
3 9 9 9 9 9 9 0 9 9 9 9 9 9 3 
3 9 9 9 9 9 9 0 9 9 9 9 9 9 3 
3 9 9 9 9 9 9 0 9 9 9 9 9 9 3 
3 9 9 9 9 9 9 0 9 9 9 9 9 9 3 
3 9 9 9 9 9 0 0 0 9 9 9 9 9 3 
3 9 9 9 9 9 0 0 0 9 9 9 9 9 3 
3 9 9 9 9 9 9 5 9 9 9 9 9 9 3 
3 3 3 3 3 3 3 3 3 3 3 3 3 3 3 