3 3 3 3 3 3 3 3 3 3 3 3 3 3 3 
3 9 9 9 9 9 0 5 0 9 9 9 9 9 3
3 9 9 9 9 9 0 0 0 9 9 9 9 9 3 
3 9 9 9 9 9 0 0 0 9 9 9 9 9 3 
3 9 9 9 9 9 9 0 9 9 9 9 9 9 3 
3 9 9 9 9 9 9 0 9 9 9 9 9 9 3 
3 9 9 9 9 9 9 0 9 9 9 9 9 9 3 
3 9 9 9 9 9 9 0 9 9 9 9 9 9 3 
3 9 9 9 9 9 9 0 9 9 9 9 9 9 3 
3 0 0 0 9 0 0 0 0 9 9 0 0 0 3 
3 5 0 0 0 0 0 10 0 0 0 0 0 5 3 
3 0 0 0 9 0 0 0 0 9 9 0 0 0 3 
3 9 9 9 9 9 0 0 0 9 9 9 9 9 3 
3 9 9 9 9 9 9 9 9 9 9 9 9 9 3 
3 9 9 9 9 9 9 9 9 9 9 9 9 9 3 
3 9 9 9 9 9 9 9 9 9 9 9 9 9 3 
3 9 9 9 9 9 9 9 9 9 9 9 9 9 3 
3 9 9 9 9 9 9 9 9 9 9 9 9 9 3 
3 9 9 9 9 9 9 9 9 9 9 9 9 9 3 
3 9 9 9 9 9 9 9 9 9 9 9 9 9 3 
3 3 3 3 3 3 3 3 3 3 3 3 3 3 3 